################################n
################################
####          #    o#   #    *##
##  # #  ######  #### #   ###### 
###   #  # @   # #    ###    o##
### ###     #      ### o########
### o ######    ##     ##$$$$$##
################################
################################