######################n
######################
##  @##o            ##
##  #o              ##
###  ##             ##
##       o        * ##
######################
######################
######################

Kirill 1/3 19 2.800000
Maximus 1/3 19 2.211000